##########
#        #
#        #
#        #
#    @   #
#        #
#        #
#        #
#  *     #
##########
