##########
#        #
#  ##    #
#  #     #
# #  @   #
# #      #
#  ##    #
#    ##  #
#     #  #
##########
