##########
#        #
#  ##    #
#  #     #
# #      #
# #      #
#  ##    #
#    ##  #
#*    #@ #
##########
