##########
#        #
#        #
#        #
#    @   #
#        #
#        #
#        #
#        #
##########
