##########
#        #
# ###### #
#   #    #
# * #@   #
#   #    #
#   #    #
# ###### #
#        #
##########
