##########
#        #
# ###### #
#   #    #
#   #@   #
#   #    #
#   #    #
# ###### #
#        #
##########
